[text]
gaming-mode = Mode de jeux 
evolution-mode = Evolution mode 
change-options = Modifier les options 
change-options-text = Tous les réglages manuels seront perdues,{%NEWLINE%} Voulez-vous écraser les paramètres? 
info = Info 
none-download-creatures = Vous ne pouvez pas télécharger et envoyer les créatures de cette quellcode.{%NEWLINE%} S'il vous plaît début de l'exécutable! 
Creature-Fragment = Créature Fragment 
Cell-Fragment = Fragment Cell 
Living-Code-Fragment = Vivre fragment de code 
All-files = Tous les fichiers 
Error = Erreur 
Can-not-save-File = Ne peut pas enregistrer le fichier! 
Save-Scene = Enregistrer la Scène 
Load-Scene = Scène de charge 
Save-Creature = Enregistrer Créature 
Open-Creature = Ouvert Créature 
Rnd-Generator = Tour génératrice 
Creature-Generator = Créatures génératrice
random-generated-creature = Je suis une créature généré au hasard. 
save-screenshot = Enregistrer capture d'écran 
Creatures = Créatures 
Food = Nourriture 
Virus = Virus 
Viruses = Virus 
DNA = ADN 
Poison = Poison 
MSG = MSG 
Rest = Repos 
Name = Nom 
Author = Auteur 
Energy = L'énergie 
Conection-to-Server-failed = Connexion au serveur a échoué! 
old-Version = Vous avez une ancienne version! 
Your-version = Votre version est 
newst-version = La version est newst 
You-have-newest-version = Vous avez la version la plus récente! 
File = Fichier 
New = Nouveau 
Options = Options 
Load = Charger 
Save-As = Enregistrer sous 
ScreenShot = Ecrans 
Quit = Quitter 
Insert = Insérer 
Own-Creature = Créature propre 
Download-Creature = Télécharger Créature 
Random-Creature = Random Créature 
ADD-Food = Ajouter des aliments 
ADD-Viruses = Ajouter les virus 
Creature = Créature 
Edit = Modifier 
Kill = Tuer 
Delete = Supprimer 
Mode = Mode 
Help = Aider 
German-help = Aide allemande 
Forum = Forum 
Search-update = Recherche de mise à jour 
About = À propos de 
Homepage = Page d'accueil 
Main = Principal 
Minimal-Creatures = Minimal Créatures 
Right-Mousebutton = Bouton droit 
Delete-Objects = Supprimer les objets 
Mutation-probability = Mutation probabilité 
Settings = Paramètres 
Break = Pause 
Background = Arrière-plan 
3D-View = Vue en 3D 
Singlecore = Singlecore 
Multicore = Multipaires 
Threads = Threads 
Enable-Sounds = Activer les sons 
Ticks-per-frame = Tiques par image 
reduce-CPU-usage = réduire l'usage CPU 
Drawing = Dessin 
Draw = Dessiner 
Object-transparecy = Objet transparecy 
Statistic = Statistiques 
Creature-info = Créature info 
Important = Importants 
Special-thanks = Un merci tout spécial à 
You-use-the-software-at-your-own-risk = Vous utilisez le logiciel à vos propres risques. 
The-software-has-been-tested-much = Le logiciel a été testé beaucoup, 
however-errors-can-not-be-excluded = Toutefois, des erreurs ne peut être exclue. 
The-author-is-not-liable-for-any-damages = L'auteur n'est pas responsable de tout dommage 
of-hardware-software-or-other = de matériel, de logiciels ou d'autres. 
This-software-may-be-freely-copied-and-presented = Ce logiciel mai être librement copié et présenté. 
Licence = License 
OK = OK 
Cancel = Annuler 
Set-default = Par défaut 
Object = Objet 
Mutation = Mutation 
CodeProbability = Code probabilité 
Move = Bouger 
Rotate = Rotation 
Attack = Attaque 
Clone = Clone 
IF = SI 
Change = Changer 
Num-Cells = Num Cells 
Color = Couleur 
Creature-generation = Créature génération 
NoName = NoName 
Description = Description 
Disable-Mutation = Désactiver Mutation 
Enable-Mutation = activer Mutation
Upload = Transférer 
Male = Mâle 
Female = Femelle 
Code = Code 
Cell = Cell 
Cell-Radius = Cell Radius 
Org-Cell-Radius = Org. Cell Radius 
Cell-Code-Position = Code de la position cellules 
Export-Code = Code d'exportation 
Import-Code = Code d'importation 
Set-this-Code-for-all-Cells = Définir ce code pour toutes les cellules 
Scale-Creature = Créature échelle 
Scale = Échelle 
Set-Org-Radius = Ensemble rayon org 
Set-Rnd-Radius = Ensemble rayon Rnd
Actual = Réelles 
Orginal = Original 
Preview = Aperçu 
Cut = Couper 
Copy = Copie 
Paste = Coller 
Select-All = Sélectionner tout 
Undo = Annuler 
Redo = Refaire 
Eating = Manger 
generation = génération 
variable = variable 
male-female = hommes-femmes 
age = âge 
absorb = absorber 
Goto = Goto 
Org-Radius = Org Radius 
Radius = Rayon 
Other = Autre 
Enemy = Enemy 
Save = Sauver 
min-energy = min énergie 
Code-position = Code position 
Copy-min-energy = Copie min énergie 
Your-IP-will-be-saved = Votre adresse IP sera enregistrée! 
I-agree = Je suis d'accord 
File-Can-not-uploaded = Fichier ne peut pas téléchargé! 
That-File-is-to-big = Ce fichier est trop grande! 
How-many-Cells-du-you-want = Comment du nombre de cellules que vous voulez? 
Download-Successful = Télécharger avec succès 
File-is-corrupt = Le fichier est corrompu! 
File-not-found = Fichier non trouvé! 
Please-tell-this-the-Author = S'il vous plaît-il dire à la l'Auteur. 
find-downloaded-creature = Vous pouvez trouver le fichier téléchargé créature après un redémarrage en vertu de 
How-many-Food-do-you-want = Combien d'alimentation voulez-vous? 
How-many-Viruses-do-you-want = Combien de virus voulez-vous? 
Stop-3D-View = Stop Vue en 3D 
Multicore-slower-Singelcore = Multipaires peut être plus lent que Singelcore. 
It-can-induce-crashes = Il peut provoquer des accidents. 
Do-you-want-to-enable-it = Voulez-vous activer? 
Do-you-want-to-use-Multicore = Voulez-vous utiliser Multipaires? 
This-option-needs-a-restart = Cette option nécessite un redémarrage 
do-you-want-To-restart = Voulez-vous redémarrer? 
Save-Cell-Fragment = Enregistrer cellule fragment 
Line = Ligne 
Kill-Program = Kill-program? 
The-program-must-restart = Le logiciel doit redémarrer 
Error-backbuffer-lost = Erreur (DX7 backbuffer perdu)
All = tous
More-Creatures = tous Creatures
Energy-per-cell = plus d'énergie par cellule
Random-Value = Valeur aléatoire
Protection-Level = Niveau de Protection
Aggressive-Level = Agressif niveau
Speed = Vitesse
RotateEnemyFast = Rotation rapide à l'ennemi
Only-Big-Cells-Emit-Poison = Seulement les grandes cellules émettent poison
Emit-Poison-To-Enemy = Emit poison à l'ennemi
CopyMode = Mode de copie
AttackMode = Mode d'attaque
Generate = Générer
Random-Tooltip = Valeur aléatoire à la création créature
Num-Cells-Tooltip = Le nombre de cellules pour la création créature
Copy-min-energy-Tooltip = L'énergie minimale de copie de la créature
Protection-Level-Tooltip = 0 = pas de protection 9 = Max Protection
Aggressive-Level-Tooltip = 0 = Pas agressif 9 = Max agressif
Speed-Tooltip = La vitesse de la créature. 0 = Très faible 9 = Très rapide
CopyMode-Tooltip = Comment faire pour copier la créature
AttackMode-Tooltip = Définit le mode attaque de la créature
DNA-AttackMode-Tooltip =  Si vous utilisez l'ADN en tant que mode d'attaque, vous pouvez définir ce que l'ADN ne crier 
Send-Report = Send report
Mail-to-support = Mail to Support@Living-Code.de
E-Mail = Your E-Mail address
E-Mail-subject = E-Mail subject
E-Mail-text = E-Mail text