[text]
gaming-mode = Gaming Modus
evolution-mode = Evolution Modus
change-options = Optionen Ändern
change-options-text = Alle Manuell eingestellte einstellungen gehen verlohren,{%NEWLINE%}Möchtest sie sie dennoch überschreiben?
info = Info
none-download-creatures = Sie können mit dem Quellcode keine Lebewesen Downloaden oder Uploaden.{%NEWLINE%}Bitte verwenden sie die exe.
Creature-Fragment = Creature Fragment
Cell-Fragment = Cell Fragment
Living-Code-Fragment = Living Code Fragment
All-files = Alle Datein
Error = Error
Can-not-save-File = Die Datei kann nicht gespeichert werden.
Save-Scene = Scene Speichern
Load-Scene = Scene Laden
Save-Creature = Creature Speichern
Open-Creature = Creature Laden
Rnd-Generator = Rnd Generator
Creature-Generator = Creature Generator
random-generated-creature = Ich bin ein zufällig erstelltes Lebewesen.
save-screenshot = Screenshot Speichern
Creatures = Creatures
Food = Nahrung
Virus = Virus
Viruses = Viren
DNA = DNA
Poison = Gift
MSG = MSG
Rest = Rest
Name = Name
Author = Autor
Energy = Energie
Conection-to-Server-failed = Das verbinden zum Server ist fehlgeschlagen!
old-Version = Sie haben eine alte Version!
Your-version = Deine Version ist
newst-version = Die neueste Version ist
You-have-newest-version = Du hast die neueste Version!
File = Datei
New = Neu
Options = Optionen
Load = Laden
Save-As = Speichern unter
ScreenShot = Screenshot
Quit = Ende
Insert = Einfügen
Own-Creature = Eigenes Lebewesen
Download-Creature = Download Creature
Random-Creature = Random Creature
ADD-Food = Nahrung hinzufügen
ADD-Viruses = Viren hinzufügen
Creature = Creature
Edit = Edit
Kill = Töten
Delete = Löschen
Mode = Modus
Help = Hilfe
German-help = Deutsche Hilfe
Forum = Forum
Search-update = Update suchen
About = About
Homepage = Homepage
Main = Main
Minimal-Creatures = Mindestanzahl Creaturen
Right-Mousebutton = rechte Maustaste
Delete-Objects = Objekte Löschen
Mutation-probability = Mutations wahrscheinlichkeit
Settings = Settings
Break = Pause
Background = Hintergrund
3D-View = 3D Anzeige
Singlecore = Singlecore
Multicore = Multicore
Threads = Threads
Enable-Sounds = Sound Aktivieren
Ticks-per-frame = Ticks pro bild
reduce-CPU-usage = CPU auslastung reduzieren
Drawing = Zeichnen
Draw = Zeichnen
Object-transparecy = Objekt Transparenz
Statistic = Statistik
Creature-info = Creature info
Important = Wichtig
Special-thanks = Vielen Dank
You-use-the-software-at-your-own-risk = Die Benutzung der Software geschieht auf eigene Gefahr.
The-software-has-been-tested-much = Die Software wurde zwar viel getestet,
however-errors-can-not-be-excluded = dennoch können Fehler nicht ausgeschlossen werden.
The-author-is-not-liable-for-any-damages = Der Autor haftet nicht für eventuelle Schäden
of-hardware-software-or-other = an Hardware, Software oder anderem.
This-software-may-be-freely-copied-and-presented = Diese Software darf frei vorgeführt und kopiert werden.
Licence = Lizenz
OK = OK
Cancel = Abbrechen
Set-default = Default setzen
Object = Objekt
Mutation = Mutation
CodeProbability = Code wahrscheinlichkeit
Move = Bewegen
Rotate = Rotieren
Attack = Angreifen
Clone = Fortpflanzung
IF = IF
Change = Ändern
Num-Cells = Anzahl Zellen
Color = Farbe
Creature-generation = Creature Generation
NoName = NoName
Description = Beschreibung
Disable-Mutation = Mutation deaktivieren
Enable-Mutation = Mutation aktivieren
Upload = Upload
Male = Mänlich
Female = Weiblich
Code = Code
Cell = Zelle
Cell-Radius = Zellen Radius
Org-Cell-Radius = Org. Zellen Radius
Cell-Code-Position = Zellen Code Position
Export-Code = Code Speichern
Import-Code = Code Laden
Set-this-Code-for-all-Cells = Diesen Code für alle Zellen setzen
Scale-Creature = Creature Skalieren
Scale = Skalieren
Set-Org-Radius = Org Radius setzen
Set-Rnd-Radius = Rnd Radius setzen
Actual = Aktuell
Orginal = Orginal
Preview = Vorschau
Cut = Ausschneiden
Copy = Kopieren
Paste = Einfügen
Select-All = Alles Selektieren
Undo = Rückgängig
Redo = Wiederholen
Eating = essen
generation = Generation
variable = Variable
male-female = Geschlecht
age = Alter
absorb = absorbieren
Goto = Goto
Org-Radius = Org Radius
Radius = Radius
Other = Anderes
Enemy = Feind
Save = Speichern
min-energy = min energie
Code-position = Code position
Copy-min-energy = Copy min energie
Your-IP-will-be-saved = Deine IP wird gespeichert!
I-agree = Ich Stimme zu
File-Can-not-uploaded = Datei kann nicht Hochgeladen werden!
That-File-is-to-big = Die Datei ist zu groß!
How-many-Cells-du-you-want = Wie viele Zellen möchten sie?
Download-Successful = ERfolgreich heruntergeladen
File-is-corrupt = Die Datei ist beschädigt!
File-not-found = Datei nicht gefunden!
Please-tell-this-the-Author = Bitte teilt dies dem Autor mit.
find-downloaded-creature = Sie finden die heruntergeladene creature nach einem Neustart in
How-many-Food-do-you-want = Wie viel Nahrung möchten sie?
How-many-Viruses-do-you-want = Wie viele Viren möchten sie?
Stop-3D-View = Stop 3D Anzeige
Multicore-slower-Singelcore = Multicore kann langsammer sein als Singelcore.
It-can-induce-crashes = Dies kann Crashes verursachen.
Do-you-want-to-enable-it = Möchten sie es aktivieren?
Do-you-want-to-use-Multicore = Möchten sie Multicore verwenden?
This-option-needs-a-restart = Diese Einstellung benötigt einen Neustart
do-you-want-To-restart = Möchten sie Neustarten?
Save-Cell-Fragment = Cell Fragment Speichern
Line = Zeile
Kill-Program = Programm beenden?
The-program-must-restart = Das Programm muss meustarten
Error-backbuffer-lost = Error (DX7 backbuffer ging verlohren)
All = Alle
More-Creatures = Mehrere Lebewesen einfügen
Energy-per-cell = zusätzliche Energy pro Zelle
Random-Value = Random wert
Protection-Level = Schütz Level
Aggressive-Level = Aggressivitäts Level
Speed = Geschwindichkeit
RotateEnemyFast = Schnell zum Gegner drehen
Only-Big-Cells-Emit-Poison = Nur große zellen entsenden Gift
Emit-Poison-To-Enemy = Gift in richtung des Gegeners senden
CopyMode = Kopier Modus
AttackMode = Attackier modus
Generate = Generieren
Random-Tooltip = Wert für den Zufall der erstellten Creature
Num-Cells-Tooltip = Die Anzahl an Zellen für das ertellte Lebewesen
Copy-min-energy-Tooltip = Die Mindest energy für das Kopieren des Lebewesens.
Protection-Level-Tooltip = 0 = Keine Protection 9 = Maximale Protection
Aggressive-Level-Tooltip = 0 = Keine Aggresivität 9 = Maximale Aggresivität
Speed-Tooltip = Die geschwindichkeit des LEbewesens. 0 = sehr langsam 9 = sehr schnell
CopyMode-Tooltip = Wie sich das Lebewesen Fortpflanzen soll
AttackMode-Tooltip = Definiert die Angriffs art der Creature
DNA-AttackMode-Tooltip = Wenn du als Angriffsmodus DNA auswählst kannst du hier heraussuchen was die DNA machen soll 
Send-Report = Report senden
Mail-to-support = E-Mail an Support@Living-Code.de
E-Mail = Deine E-Mail Addresse
E-Mail-subject = E-Mail Betreff
E-Mail-text = E-Mail Text